NO ./wall10.png
SO ./wall2.png
WE ./wall1.png
EA ./wall3.png
F 32,33,33
C 19,191,194
        1111111111111111111111111
        1000000000110000000000001
        1011000001110000000000001
        1001000000000000000000001
111111111011000001110000111111001
100000000011000001110111111111111
11110111111111011100000010001
11110111111111011101010010N01
11010000110101011100000010111
10010000000000001100000010001
10010000000000001101010000001
1100000111010101111101111000111
11110111 1110101 101111010001
11111111 1111111 111111111111
